########################
#......................#
#......................#
#..####.............E..#
#..#..#................#
#..#..#................#
#..#..#.............^..#
#..#..#.............^..#
#..#..#.....#####...^..#
#..#..#.....#.........^#
#..#..#..S..#..........#
#..#..#.....#..........#
#..####.....#..........#
########################
