########################
#......................#
#......................#
#...........^^^^^......#
#......................#
#....S.................#
#..........####........#
#.........#............#
#.........#....^^^^....#
#..N......#............#
#.........#............#
#.........####......E..#
#......................#
########################
