########################
#......................#
#..........N...........#
#......................#
#......#####...........#
#....S.....#......E....#
#..........#...........#
#..........#....^^^^...#
#..........#...........#
#..........#...........#
#..........#####.......#
#......................#
#......................#
########################
